id;latitude;longitude;TSF(ha);WRP(ha);PIT(ha);TOT(ha);PROV
#2400;-67,13699976;45,16139621;0;0;41;41;NB
#2402;-67,04130379;45,8488465;20;0;0;20;NB
#2408;-65,87768215;47,08589363;0;151;0;151;NB
#2409;-66,07114002;47,27611075;334;0;0;334;NB
#2410;-65,87040423;47,4783789;704;0;0;704;NB
#2411;-66,29055759;47,5646644;0;72;0;72;NB
#2412;-66,03935576;47,6517328;0;0;28;28;NB
#2416;-66,73819344;45,95860837;0;0;52;52;NB
#2417;-64,87181589;46,16637361;0;126;45;171;NB
#2418;-64,5662781;46,05215664;0;0;66;66;NB
#3007;-95,65353434;51,03062156;135;0;0;135;MB
#2087;-95,44738377;50,43315492;0;76;0;76;MB
#2100;-101,6504587;56,6184519;367;0;0;367;MB
#2101;-101,0222236;56,84918842;4332;0;0;4332;MB
#2102;-99,63703;56,47324168;466;338;0;804;MB
#2096;-95,20608953;56,3519502;26;670;0;696;MB
#2108;-96,89220931;49,97488947;788;0;0;788;MB
#2109;-97,28037102;50,16195204;893;0;0;893;MB
#2103;-97,82937027;55,71452918;1054;605;0;1659;MB
#2104;-100,011169;54,89976848;160;0;0;160;MB
#2107;-101,224424;53,86390041;0;142;0;142;MB
#2117;-98,76715378;50,73103043;66;0;0;66;MB
#2423;-63,56081975;44,71337721;0;107;0;107;NS
#2013;-64,04961073;45,019028;0;235;76;311;NS
#2014;-63,41635789;45,01291135;0;0;206;206;NS
#2015;-63,34415149;45,02416109;75;35;25;135;NS
#2012;-64,26107333;44,60821535;0;31;0;31;NS
#2011;-65,69242686;44,10540413;342;0;63;405;NS
#2419;-63,65352693;45,84190555;0;24;0;24;NS
#2420;-64,0819802;44,97882935;0;0;141;141;NS
#2421;-63,53432103;44,73410166;0;0;120;120;NS
#2422;-63,6117909;44,74366951;0;0;160;160;NS
#2403;-61,41842528;45,63017353;0;155;0;155;NS
#2404;-61,51720206;45,4922247;0;20;0;20;NS
#2405;-61,25386351;45,88853924;0;127;0;127;NS
#2406;-60,91197549;46,00218574;0;0;177;177;NS
#2407;-63,53879198;45,55242535;91;0;0;91;NS
#2097;-95,99868731;65,07499424;148;98;59;305;NU
#2098;-96,06401158;65,02558876;320;386;0;706;NU
#2365;-111,2798582;65,72780913;535;0;0;535;NU
#3006;-105,4323276;49,22469065;0;300;256;556;SK
#2110;-105,1892365;50,43591802;493;0;0;493;SK
#2106;-102,7969001;54,63928228;0;217;0;217;SK
#2111;-106,6777557;50,4311163;3853;0;0;3853;SK
#2112;-101,9822617;49,13179405;0;33;0;33;SK
#2113;-102,8560981;49,10478718;874;3403;0;4277;SK
#2114;-101,5417025;50,46296509;595;0;0;595;SK
#2115;-101,8675466;50,66186665;435;0;0;435;SK
#2116;-101,9436646;50,7309404;554;0;0;554;SK
#2118;-105,3879013;50,65017515;212;0;0;212;SK
#2119;-105,200123;51,84155788;792;0;0;792;SK
#3005;-104,7128528;51,89928087;0;76;0;76;SK
#2120;-105,782838;51,92635716;592;0;0;592;SK
#2121;-106,0865593;51,94210814;587;0;0;587;SK
#2122;-107,0760139;52,00722878;690;0;0;690;SK
#2123;-106,8700891;52,09051036;408;0;0;408;SK
#3004;-109,1052983;52,43423289;26;0;0;26;SK
#2124;-106,366712;52,09911261;181;0;0;181;SK
#2125;-106,3006741;52,11405711;0;0;107;107;SK
#2130;-103,8302177;58,34420789;0;84;0;84;SK
#2126;-105,0522702;57,76342298;74;0;0;74;SK
#2105;-101,9018738;54,77179537;395;126;0;521;SK
#2127;-103,6991572;58,17657406;316;0;0;316;SK
#2128;-103,6377753;58,25430924;0;57;0;57;SK
#2129;-103,8035597;58,25849296;0;218;0;218;SK
#3002;-104,545403;58,0663819;44;0;0;44;SK
#2099;-105,6438698;57,20316137;450;323;44;817;SK
#3003;-103,5947892;55,68952242;59;0;0;59;SK
#2002;-57,45686713;50,27664569;75;0;10;85;NL
#2003;-56,18655728;49,98736562;0;327;72;399;NL
#2004;-56,12710063;49,96201938;0;97;8;105;NL
#2005;-56,07689401;49,96560619;7;13;2;22;NL
#2006;-56,08801612;49,89425199;77;16;0;93;NL
#2007;-55,20568627;48,71883545;26;0;0;26;NL
#2008;-56,48916265;48,65130407;104;56;0;160;NL
#2009;-56,87556016;48,81777967;185;0;0;185;NL
#2000;-66,86172524;53,0012827;1948;3210;0;5158;NL
#2001;-66,92747889;52,9070247;1700;1363;0;3063;NL
#2414;-62,09472808;56,33129628;16;124;19;159;NL
#2010;-59,02031518;48,55469648;0;267;0;267;NL
#2360;-114,3449374;62,50492266;127;136;0;263;NT
#2361;-110,3021525;64,49385542;163;636;0;799;NT
#2362;-110,6210517;64,71353276;785;1555;0;2340;NT
#2363;-110,8907274;63,60015316;188;0;0;188;NT
#3001;-109,1979846;63,43658128;0;15;0;15;NT
#2364;-111,1722624;64,04555618;119;0;0;119;NT
#2359;-114,4303037;60,87439886;800;0;670;1470;NT
#2367;-133,7385173;60,98947401;0;138;0;138;YT
#2369;-135,0573407;60,64363297;83;0;0;83;YT
#2370;-137,2451072;62,61588669;0;345;0;345;YT
#2371;-133,3781356;62,35013211;308;540;0;848;YT
#2372;-133,2214737;62,25940104;0;484;0;484;YT
#2373;-138,8284001;62,73887892;0;0;76;76;YT
#2131;-111,3702333;56,64090881;95;0;0;95;AB
#2132;-111,3478524;56,6486188;0;45;0;45;AB
#2133;-111,2944705;56,66260089;0;243;0;243;AB
#2134;-111,4622299;56,78245895;0;324;0;324;AB
#2135;-111,4341922;56,84459324;82;0;0;82;AB
#2136;-111,5021539;57,00931574;44285;0;0;44285;AB
#2137;-111,343963;57,24226809;5006;0;0;5006;AB
#2138;-111,5518767;57,18232668;436;0;0;436;AB
#2139;-111,5056834;57,21822105;1441;0;0;1441;AB
#2140;-111,5314509;57,30701312;18015;0;0;18015;AB
#2141;-111,9181515;57,3480764;6962;0;0;6962;AB
#2142;-111,0789217;57,3827327;9023;0;0;9023;AB
#2144;-113,8259259;50,85527926;279;0;0;279;AB
#2145;-114,1933745;51,16847396;0;0;413;413;AB
#2146;-113,0896943;53,8543393;223;0;0;223;AB
#2350;-117,0355771;53,13749067;0;0;3560;3560;AB
#2351;-114,2796215;53,3172782;0;0;1024;1024;AB
#2352;-114,4742673;53,44631563;169;0;3414;3583;AB
#2147;-112,945575;53,90835496;89;0;0;89;AB
#2149;-117,474977;53,57187611;188;158;952;1298;AB
#4000;-111,744281;51,4320948;523;572;400;1495;AB
#4001;-115,1313836;51,06851438;0;47;66;113;AB
#4002;-114,2442379;51,07360468;0;87;0;87;AB
#4003;-114,7453353;53,30838243;0;90;0;90;AB
#4004;-113,802666;53,67715792;0;0;202;202;AB
#4005;-113,9281206;53,69655287;0;0;126;126;AB
#4006;-114,1421166;53,63916566;0;0;59;59;AB
#4007;-117,4362913;53,07769972;0;3093;196;3289;AB
#4008;-119,1940081;54,02679335;0;739;1562;2301;AB
#2143;-117,2485994;49,13495486;73;0;0;73;BC
#2357;-114,8491847;50,19057407;0;0;5910;5910;BC
#2358;-114,6538494;49,4947178;0;0;688;688;BC
#2377;-120,5284179;49,3377199;162;799;400;1361;BC
#2378;-122,1882568;49,07287216;0;0;117;117;BC
#2379;-122,1701367;49,13235706;0;0;79;79;BC
#2380;-123,740216;49,48262084;0;0;300;300;BC
#2381;-123,4668853;48,53777751;0;0;57;57;BC
#2382;-125,6021161;49,57515421;0;0;111;111;BC
#2383;-124,5438352;49,7165939;0;0;992;992;BC
#2384;-124,6153942;49,78478961;0;0;166;166;BC
#2385;-127,4818839;50,60328381;0;0;244;244;BC
#2386;-120,9194987;50,20519441;157;274;0;431;BC
#2387;-121,0214065;50,46917439;2846;3055;512;6413;BC
#2388;-120,5188464;50,65467447;200;280;0;480;BC
#2389;-120,90633;52,09603924;0;246;0;246;BC
#2390;-122,2802951;52,5238564;936;1209;208;2353;BC
#2391;-121,6158949;52,54076973;372;1026;0;1398;BC
#2392;-127,0033644;53,29892081;0;0;63;63;BC
#2393;-125,1128022;54,03659978;704;811;218;1733;BC
#2394;-126,2699495;54,19428963;140;232;40;412;BC
#2395;-126,7262627;54,38398815;0;0;200;200;BC
#2396;-126,1581268;54,93784838;0;253;66;319;BC
#2397;-126,225044;54,99029711;0;462;37;499;BC
#2148;-119,9940592;49,87562729;384;262;53;699;BC
#2398;-129,4222863;55,42155164;0;147;0;147;BC
#2399;-123,994558;55,12144986;1245;0;0;1245;BC
#2353;-115,9426129;49,65375022;907;0;0;907;BC
#2354;-115,7607931;49,91806517;119;0;0;119;BC
#2355;-114,810443;49,74261598;0;0;3210;3210;BC
#2356;-114,7747937;49,94742807;0;0;1430;1430;BC
#2366;-126,6738252;57,02067833;564;503;100;1167;BC
#2368;-133,3985123;59,7089339;0;0;479;479;BC
#5000;-122,220713;55,61013906;0;0;652;652;BC
#5001;-121,8300912;55,39368113;0;0;580;580;BC
#5002;-121,2160168;55,02447528;0;4370;1351;5721;BC
#5003;-127,1872109;53,67929348;278;182;78;538;BC
#5004;-122,6556045;49,28676558;0;0;58;58;BC
#5005;-122,4111741;49,02911171;0;0;145;145;BC
#5006;-123,883622;49,74462301;0;123;0;123;BC
#5007;-127,140704;50,58355965;0;0;217;217;BC
#6000;-70,76306131;46,8047304;0;0;61;61;QC
#6001;-71,20333807;46,85918583;0;0;19;19;QC
#6002;-71,39139264;46,90014601;0;0;116;116;QC
#6003;-74,03150965;45,72649489;0;0;91;91;QC
#6004;-73,92805297;45,61906336;0;0;52;52;QC
#6005;-73,53442751;45,61938956;0;90;95;185;QC
#6006;-73,61996923;45,57236263;0;88;87;175;QC
#2415;-66,91321897;54,81465628;0;1901;441;2342;QC
#0001;-77,74079948;48,09433327;350;68;29;447;QC
#0002;-78,13292413;48,11322339;969;411;158;1538;QC
#0004;-78,44068988;48,24857943;292;29;3;324;QC
#0005;-79,22062259;49,56401793;234;11;0;245;QC
#0006;-77,91793002;48,11148346;106;15;0;121;QC
#0007;-77,98484939;49,13196105;84;22;0;106;QC
#0008;-79,19727401;48,20583953;66;0;0;66;QC
#0009;-77,55909433;48,1578408;145;6;0;151;QC
#0010;-77,64847013;48,13666709;60;21;0;81;QC
#0011;-76,6837274;49,25037962;206;30;0;236;QC
#0012;-76,14272006;49,49451049;71;31;0;102;QC
#0013;-79,23254473;48,22679328;71;30;0;101;QC
#0014;-77,66673776;48,52765721;75;16;14;105;QC
#0015;-77,41887396;48,09325108;60;0;0;60;QC
#0016;-77,69531715;48,07348142;267;0;0;267;QC
#0017;-77,61589394;48,07996126;339;0;0;339;QC
#0018;-79,23114946;48,50846225;90;0;0;90;QC
#0019;-78,38914585;48,32920084;41;20;0;61;QC
#0021;-78,50134447;48,21615463;0;35;0;35;QC
#0022;-79,08493655;48,22676798;528;75;0;603;QC
#0025;-79,07557117;48,32166834;105;0;0;105;QC
#0026;-78,3956565;48,2363113;11;0;0;11;QC
#0028;-78,34234949;48,23392096;28;0;0;28;QC
#0030;-79,02609918;48,18035338;5;10;3;18;QC
#0031;-78,52527944;48,25473314;323;169;22;514;QC
#0035;-79,13525375;48,36345404;0;47;0;47;QC
#0037;-79,05602936;48,35415258;65;35;0;100;QC
#0038;-79,3580252;49,00245876;73;0;0;73;QC
#0042;-78,28387685;48,22794661;2;8;0;10;QC
#0044;-77,86356877;48,09122923;2;25;0;27;QC
#0045;-79,12691552;48,28115581;2;3;0;5;QC
#0046;-67,33282758;52,77387074;2480;1475;640;4595;QC
#0047;-68,0569522;51,85292765;663;143;12;818;QC
#0048;-67,34122618;52,34941176;0;269;0;269;QC
#0049;-67,24608331;52,8527822;300;511;113;924;QC
#0050;-63,41438244;50,555404;0;218;46;264;QC
#0051;-71,91147035;45,31465769;16;0;0;16;QC
#0053;-71,96449681;45,77544539;58;441;251;750;QC
#0054;-71,36101929;46,03017167;0;2000;522;2522;QC
#0056;-65,5175134;48,96341288;772;616;67;1455;QC
#0057;-75,53951174;46,38093671;34;78;32;144;QC
#0058;-73,44494211;61,56013275;112;132;0;244;QC
#0059;-73,63840802;61,68112716;184;0;338;522;QC
#0055;-73,9671418;61,81636781;0;955;24;979;QC
#0060;-76,08735325;52,7055426;0;338;0;338;QC
#0061;-77,78031488;49,74865741;551;0;0;551;QC
#0062;-74,47369636;51,00303313;304;305;143;752;QC
#0063;-74,86574596;49,7922035;192;0;0;192;QC
#0065;-72,18641773;52,81572532;0;269;0;269;QC
#0067;-77,69310675;49,68941941;85;77;12;174;QC
#0070;-71,15845761;48,53368147;93;137;0;230;QC
#0074;-74,32488483;49,85969778;282;100;0;382;QC
#0075;-78,94843805;49,79909712;543;122;0;665;QC
#0076;-78,37203827;49,48220511;220;0;0;220;QC
#0077;-78,39785773;49,44368217;51;0;0;51;QC
#0078;-78,90807755;48,38051854;126;0;0;126;QC
#0079;-78,94829655;48,32580175;0;20;4;24;QC
#0080;-79,06800139;48,25167723;0;0;8;8;QC
#0081;-79,03157661;48,21120967;18;0;0;18;QC
#0082;-77,82476296;48,40332425;99;116;44;259;QC
#0083;-78,03037271;48,14025739;109;0;0;109;QC
#0084;-78,00058467;48,1072062;179;0;0;179;QC
#0085;-77,84145404;48,05308616;80;0;0;80;QC
#0086;-77,60032773;48,13153151;129;0;0;129;QC
#0087;-77,55359725;48,10480325;56;0;0;56;QC
#0088;-77,491336;48,09827054;25;30;0;55;QC
#0089;-77,42977769;48,11171854;0;41;0;41;QC
#0090;-77,45923509;48,06679476;0;21;7;28;QC
#0091;-78,47189954;48,25386815;0;12;7;19;QC
#0092;-78,94214859;47,36193381;18;0;0;18;QC
#0093;-71,26775252;45,82082432;175;0;4;179;QC
#0094;-71,14608847;48,41629244;193;122;0;315;QC
#0095;-71,20246016;48,34424654;115;0;0;115;QC
#0096;-66,32624048;50,21503422;168;0;0;168;QC
#0097;-71,03785081;46,24752363;96;0;0;96;QC
#0098;-71,08872607;46,22622861;0;50;0;50;QC
#0099;-71,00767768;46,27279914;0;54;0;54;QC
#0100;-71,83977171;45,81938143;0;20;16;36;QC
#0101;-71,60426349;45,62102413;0;115;50;165;QC
#0102;-71,59006962;45,65594731;0;20;9;29;QC
#0103;-72,55602533;45,64027485;0;20;16;36;QC
#0104;-73,43560873;45,31840965;0;0;117;117;QC
#0105;-73,63423404;45,17235132;0;0;46;46;QC
#0106;-73,64557662;45,13837001;0;0;17;17;QC
#0107;-73,74618821;45,01253953;0;0;88;88;QC
#0108;-74,43154612;45,3860116;0;40;30;70;QC
#0109;-73,33516399;45,66520116;0;0;123;123;QC
#0110;-72,86911586;45,58389949;0;79;59;138;QC
#0111;-73,00769725;45,10967648;0;44;59;103;QC
#0112;-73,04654286;45,07622199;0;63;21;84;QC
#0113;-71,93765663;45,33871381;0;46;22;68;QC
#0114;-71,92718342;45,35738202;0;43;11;54;QC
#0115;-71,82049552;45,291585;0;0;40;40;QC
#0116;-75,77154307;48,98882237;0;12;17;29;QC
#0117;-66,7925333;50,04017503;79;0;0;79;QC
#0118;-73,40397767;46,28498566;0;0;129;129;QC
#0119;-73,52446343;45,34485039;0;0;93;93;QC
#0120;-73,6962658;45,58391625;0;0;154;154;QC
#0121;-73,62311803;45,66683911;0;0;59;59;QC
#0122;-73,68367981;45,6430255;0;0;146;146;QC
#0123;-74,34610376;45,26266702;0;0;258;258;QC
#0124;-74,17664411;45,38408046;0;153;0;153;QC
#0125;-74,15980799;45,41773974;0;0;37;37;QC
#6010;-75,84435084;45,4335063;0;0;109;109;QC
#7000;-74,76315137;45,59829351;0;45;0;45;ON
#7001;-75,98487106;45,23125343;0;0;128;128;ON
#7002;-76,85037208;44,30600517;0;20;0;20;ON
#7003;-77,53615486;44,49444662;0;0;46;46;ON
#7004;-77,65684739;44,47337183;0;257;35;292;ON
#7005;-78,07462433;44,31059105;0;0;49;49;ON
#7006;-78,59184271;44,21252452;0;0;50;50;ON
#7007;-78,69331088;43,88584153;0;0;100;100;ON
#7008;-79,11484186;44,03931388;0;0;260;260;ON
#7009;-79,25248868;44,02334309;0;0;226;226;ON
#7010;-79,96695584;43,53771252;0;0;448;448;ON
#7011;-80,1589241;43,44503838;0;0;415;415;ON
#7012;-80,41144042;43,46146509;0;0;55;55;ON
#7013;-80,39486598;43,3296887;0;0;118;118;ON
#7014;-80,37059551;43,35553574;0;0;208;208;ON
#7015;-80,29997857;43,32396069;0;0;56;56;ON
#7016;-80,40940047;43,18011626;0;0;62;62;ON
#7017;-80,01422112;43,31483119;0;0;435;435;ON
#7018;-79,29815344;42,89598446;0;0;113;113;ON
#7019;-79,00980152;42,9224811;0;0;63;63;ON
#7020;-79,16668673;43,1265557;0;0;233;233;ON
#7021;-79,07207619;43,14845701;333;0;0;333;ON
#7022;-79,4029001;43,13582449;0;0;69;69;ON
#7023;-79,48951831;43,11249024;0;0;63;63;ON
#7024;-79,93004143;42,94335678;0;0;139;139;ON
#7025;-80,03495331;42,96364128;0;0;52;52;ON
#5000;-83,09246425;42,11921943;103;0;137;240;ON
#5001;-83,0084491;42,15734831;0;0;99;99;ON
#5002;-82,86540023;42,08997683;0;60;0;60;ON
#5003;-82,64739653;42,09045951;0;0;54;54;ON
#5004;-81,04694603;43,04017278;0;0;139;139;ON
#5005;-80,85799572;43,06674012;0;0;329;329;ON
#5006;-80,90068113;43,10134615;0;0;127;127;ON
#5007;-81,16224828;43,2446579;0;0;115;115;ON
#5008;-80,7629243;43,10409728;0;0;68;68;ON
#2093;-85,92005597;48,69716874;448;147;41;636;ON
#2094;-87,10505787;48,79945629;34;50;0;84;ON
#2095;-85,77472622;49,1601246;342;55;0;397;ON
#2019;-74,74632062;45,08279284;0;0;78;78;ON
#3011;-84,44228342;48,30679447;70;52;0;122;ON
#2020;-75,20744161;45,23360126;0;0;48;48;ON
#2021;-75,57264582;45,30392502;0;0;295;295;ON
#2022;-75,54692497;45,0693785;0;0;50;50;ON
#2023;-75,61916496;44,97604717;0;0;59;59;ON
#2024;-75,56649298;45,44671693;0;0;74;74;ON
#2025;-75,77285234;45,23599956;106;0;322;428;ON
#2026;-75,81986047;45,278258;0;0;160;160;ON
#2027;-75,96643467;45,26791218;14;0;43;57;ON
#2028;-75,95818374;45,29195268;0;0;89;89;ON
#2029;-76,4972647;45,15145717;0;76;23;99;ON
#2030;-77,13193097;44,05641074;0;0;102;102;ON
#2031;-77,88047264;43,98553923;0;0;152;152;ON
#2032;-78,67849151;44,06701125;0;0;463;463;ON
#2033;-80,24446179;44,38360503;0;0;50;50;ON
#2035;-80,86022968;44,56538926;0;0;56;56;ON
#2036;-79,49544615;44,68059935;0;0;230;230;ON
#2037;-79,65269622;44,77065988;0;0;109;109;ON
#2038;-79,41324676;44,73856904;0;0;84;84;ON
#2039;-79,15206638;44,53225662;0;0;108;108;ON
#2040;-79,09468717;44,59205363;0;0;296;296;ON
#2041;-79,06930566;44,22743903;0;0;275;275;ON
#2042;-77,94864304;44,66966055;0;234;0;234;ON
#2043;-75,98257718;44,64939183;0;0;43;43;ON
#2044;-76,12858722;45,25722529;0;0;88;88;ON
#2045;-79,55376102;44,55795576;0;281;0;281;ON
#2046;-79,20803912;44,68619994;0;0;161;161;ON
#2047;-79,09206627;45,72697964;38;0;0;38;ON
#2048;-79,48120307;46,42857862;0;0;200;200;ON
#2049;-83,20688314;45,90077338;17;0;281;298;ON
#2050;-81,57793253;45,95859057;0;0;50;50;ON
#2051;-80,80250248;46,58400748;230;418;0;648;ON
#2052;-80,82676607;46,5597393;0;305;0;305;ON
#2053;-81,00529386;46,52794917;0;333;0;333;ON
#2054;-81,07878134;46,48232146;2587;1325;34;3946;ON
#2055;-81,34463688;46,65784966;358;55;167;580;ON
#2056;-81,36577987;46,57180392;0;291;0;291;ON
#2057;-82,60343328;46,46481727;879;0;0;879;ON
#2058;-81,03626296;46,76455374;0;0;19;19;ON
#2059;-82,08182662;48,2041336;0;149;16;165;ON
#2060;-81,00203301;47,88165673;0;46;0;46;ON
#2061;-80,6865191;47,94743123;83;102;13;198;ON
#2062;-79,92149629;48,07907762;814;201;117;1132;ON
#2063;-82,09247561;48,66583334;19;20;0;39;ON
#2064;-81,60281592;48,59358017;417;0;0;417;ON
#2065;-81,23146861;48,45838745;723;276;71;1070;ON
#2066;-81,31417729;48,47117329;205;0;84;289;ON
#2067;-81,27982986;48,50132802;725;376;0;1101;ON
#2068;-81,09349212;48,56206767;1870;610;53;2533;ON
#2069;-81,37363752;48,68810333;31;570;0;601;ON
#2071;-80,76019983;48,55300354;153;0;0;153;ON
#2072;-80,33118998;48,52993526;131;113;45;289;ON
#2073;-80,28304287;48,4921122;38;69;1;108;ON
#2074;-80,40419106;48,45541361;0;25;0;25;ON
#2075;-80,24807153;48,55960537;0;76;16;92;ON
#2076;-80,21299463;48,599018;5;0;0;5;ON
#2077;-79,73182207;48,48682768;179;0;0;179;ON
#2078;-79,7182836;50,01340344;750;922;160;1832;ON
#2079;-82,8250201;49,2887148;293;212;47;552;ON
#2080;-83,90158905;52,82158149;331;360;75;766;ON
#2081;-84,39924386;46,51377199;0;402;0;402;ON
#2082;-84,34628128;46,58376261;0;228;0;228;ON
#2083;-90,36695937;51,50278331;177;0;0;177;ON
#2084;-90,07705408;51,41530417;87;0;0;87;ON
#2085;-93,75013932;51,06595471;347;0;0;347;ON
#3008;-93,73914544;51,12567206;22;0;0;22;ON
#2086;-93,36993935;50,81599162;1310;276;101;1687;ON
#2088;-90,95446923;49,86798161;225;278;9;512;ON
#2089;-89,31780161;48,56575234;0;354;0;354;ON
#2090;-89,01228827;48,55186809;0;101;0;101;ON
#2091;-90,21089737;48,58189947;151;0;0;151;ON
#2092;-89,62217985;49,15952315;384;282;44;710;ON
#2413;-81,15525056;48,32084986;23;0;0;23;ON
#3010;-84,53965962;48,35532977;0;66;0;66;ON
#3013;-81,55240477;48,38164227;6;18;0;24;ON
#3014;-81,17166232;48,74414103;9;23;0;32;ON
#3015;-80,02041578;48,16208943;138;0;0;138;ON
#3012;-83,2587607;47,87151822;0;3;0;3;ON
#3016;-85,43005255;48,10571384;250;42;0;292;ON
#3009;-90,3525987;52,60538742;215;47;6;268;ON
#3017;-83,74656773;46,30602082;0;49;54;103;ON
#3018;-83,42458894;46,27613554;0;146;0;146;ON
#3019;-81,34679048;46,43002099;0;30;10;40;ON
#3020;-80,23170985;44,14194054;0;0;80;80;ON
#3021;-79,98659829;43,84865891;0;0;830;830;ON
#3022;-80,00235596;43,61786634;0;0;169;169;ON
#3023;-80,14606408;43,80892279;0;0;68;68;ON
